C	W	W	W	W	W	W	W	W	W	W	W	W	W	W	W	W	W	W	W	W	W	W	R	R	W	W	W	W	W	W	W	W	W	W	W	W	W	W	W	W	W	W	W	U	W	W	W	W	C														
W	W	W	W	W	W	W	W	W	W	W	W	W	W	W	W	W	W	W	W	W	W	W	R	R	R	W	W	W	W	W	W	W	W	W	W	W	W	W	W	W	W	W	W	U	W	W	W	W	W														
W	W	W	W	W	W	W	W	W	W	W	W	W	W	W	W	W	W	W	W	P	W	W	W	R	R	R	W	W	W	P	W	W	P	W	W	W	W	W	W	W	W	W	W	U	W	W	W	W	W														
W	W	W	W	W	W	W	W	W	W	W	W	W	W	W	W	W	W	P	W	W	P	W	W	W	R	R	W	W	P	W	W	P	W	W	W	W	W	W	W	W	W	W	W	U	W	W	W	W	W														
W	W	W	W	W	W	W	W	W	W	W	W	W	W	W	W	W	W	W	P	W	P	P	W	B	B	B	B	B	P	W	P	W	W	W	W	W	W	W	W	W	W	W	W	W	P	W	W	W	W														
W	W	W	W	W	W	W	W	W	W	W	W	W	W	W	W	W	P	P	W	P	P	W	W	W	W	R	R	W	W	W	W	W	W	W	W	R	W	W	W	W	W	W	W	W	P	W	W	W	W														
W	W	W	W	W	W	W	W	W	W	W	W	W	W	W	W	W	W	W	W	W	W	W	W	W	W	R	R	R	R	W	W	W	R	R	R	R	R	W	W	W	W	W	W	W	P	W	W	W	W														
W	W	W	W	W	W	W	W	W	W	W	W	W	W	W	W	W	W	W	W	W	W	W	W	W	W	W	W	R	R	R	W	R	R	R	R	R	R	R	W	W	W	W	P	P	W	W	W	W	W														
W	W	W	W	W	W	W	W	W	W	W	W	W	W	W	W	W	W	W	W	W	W	W	W	W	W	W	W	W	R	R	R	R	R	R	R	R	R	R	W	W	W	W	W	P	P	W	W	W	W														
W	W	W	W	W	W	W	W	W	W	W	W	W	W	W	W	W	W	W	W	W	W	W	W	W	W	W	W	W	W	R	R	R	R	R	R	R	R	W	W	W	W	W	W	P	W	W	W	W	W														
W	W	W	W	W	W	W	W	W	W	W	W	W	W	W	W	W	W	W	W	W	W	W	W	W	W	W	W	W	W	W	W	R	R	R	R	R	W	W	W	P	W	W	W	W	W	W	W	W	W														
W	W	W	W	W	W	W	W	W	W	W	W	W	W	W	W	W	W	W	W	W	W	W	W	W	W	W	W	W	W	W	W	W	R	R	R	W	W	W	P	W	W	W	W	W	W	W	W	W	W														
W	W	W	W	W	W	W	W	W	W	W	W	W	W	W	W	W	W	W	W	W	W	W	W	W	W	W	W	W	W	W	W	W	W	W	W	W	W	P	P	W	W	W	W	W	W	W	W	W	W														
W	W	W	W	W	W	W	W	W	W	W	W	W	W	W	W	W	W	W	W	W	W	W	W	W	W	W	W	W	W	W	W	W	W	W	W	U	W	W	U	U	U	W	W	W	W	W	W	W	W														
W	W	W	W	P	W	W	W	W	W	W	W	W	W	W	W	W	W	W	W	W	W	W	W	W	W	W	W	W	W	W	W	W	W	W	W	U	W	W	W	W	U	W	W	W	W	W	W	W	W														
W	W	W	W	P	P	W	W	W	W	W	W	W	W	W	W	W	W	W	W	W	W	W	W	W	W	W	W	M	M	W	W	W	W	W	W	U	W	W	W	W	U	W	W	W	W	W	W	W	W														
W	W	W	W	P	W	P	U	U	U	U	U	W	W	W	W	W	W	W	W	W	W	W	W	W	W	W	W	M	M	W	W	W	W	W	W	U	W	W	W	W	U	W	W	W	W	W	W	W	W														
W	W	W	W	W	W	P	W	W	W	W	W	W	W	W	W	W	W	W	W	W	W	W	W	W	M	M	M	M	M	M	W	W	W	W	W	U	W	W	W	W	U	W	W	W	W	W	W	W	W														
W	W	W	W	W	W	U	W	W	W	W	W	W	W	W	W	W	W	W	W	W	W	W	W	W	M	M	M	M	M	M	W	W	W	W	W	W	W	W	W	W	U	W	W	W	W	W	W	W	W														
W	W	W	W	W	W	U	W	W	W	W	U	W	W	W	W	W	W	W	W	W	W	W	W	W	M	M	M	M	M	M	W	W	W	W	W	W	W	W	W	W	U	W	W	W	W	W	W	W	W														
W	W	W	W	W	W	W	W	W	W	W	U	W	W	W	W	W	W	W	W	W	W	W	W	M	M	M	M	M	M	W	W	W	W	W	W	W	W	W	W	W	W	W	W	W	W	W	W	W	W														
W	W	W	W	W	W	W	W	W	W	W	U	W	W	W	W	W	W	W	W	W	W	W	W	M	M	M	M	M	M	W	W	W	W	W	W	W	W	W	W	W	W	W	W	W	W	W	W	W	W														
W	W	W	W	W	P	U	U	U	U	U	U	W	W	W	W	W	W	W	W	W	W	M	M	M	M	M	M	M	M	W	W	W	W	W	W	W	W	W	W	W	W	W	W	W	W	W	W	W	W														
W	W	W	W	P	W	W	W	W	W	W	W	W	W	W	W	W	W	W	M	M	M	M	M	M	M	M	M	M	M	W	W	W	W	W	W	W	W	W	W	W	W	W	W	W	W	W	W	W	W														
W	W	W	W	W	P	W	W	W	W	W	W	W	W	W	W	W	W	W	M	M	M	M	M	M	M	M	M	W	W	W	W	W	W	W	W	W	W	W	W	W	W	W	W	W	W	W	W	W	W														
W	W	W	W	W	P	W	W	W	W	W	W	W	W	W	W	W	M	M	M	M	M	M	M	M	M	M	M	W	W	W	W	W	W	W	W	W	W	W	W	W	W	W	W	W	W	W	W	W	W														
W	W	W	W	P	W	W	W	W	W	W	W	W	W	W	W	W	M	M	M	M	M	M	M	M	W	W	W	W	W	W	W	W	W	W	W	W	W	W	W	W	W	W	W	W	W	W	W	W	W														
W	W	W	P	W	W	W	W	W	R	R	R	W	W	W	W	M	M	M	M	W	W	W	W	W	W	W	W	W	W	W	W	W	W	W	W	W	W	W	W	W	W	W	W	W	W	W	U	U	U														
W	W	W	P	P	W	W	W	R	R	R	R	R	W	W	W	M	M	M	M	W	W	W	W	W	W	W	W	W	W	W	W	W	W	W	W	W	W	W	W	W	W	W	W	W	U	W	W	W	W														
W	W	W	W	W	W	W	W	R	R	R	R	R	W	M	M	M	M	M	M	W	W	W	W	W	W	W	W	W	W	W	W	W	W	W	W	W	W	W	W	W	W	W	W	W	U	W	W	W	W														
W	W	W	W	W	W	W	W	W	R	R	R	R	W	M	M	M	M	W	W	W	W	W	W	W	W	W	W	W	W	P	W	W	W	W	W	W	W	W	W	W	W	W	W	W	U	W	W	W	W														
W	W	W	B	W	W	W	W	W	W	W	R	R	R	W	M	W	W	W	W	W	W	W	W	W	W	W	W	W	P	W	P	P	W	W	W	W	W	W	W	W	W	W	W	W	U	W	W	W	W														
R	R	R	B	W	W	W	W	W	W	W	W	W	R	R	W	W	W	W	W	W	W	W	W	W	W	W	W	W	W	W	P	W	W	W	W	W	W	W	W	W	W	W	W	W	U	U	U	W	W														
R	R	R	B	R	R	W	W	W	W	W	W	B	B	B	B	W	W	W	W	W	W	W	W	W	W	W	W	W	P	W	W	W	P	W	W	W	W	W	W	W	W	W	W	W	W	W	W	P	W														
W	W	W	B	R	R	R	W	W	W	W	W	B	B	B	B	W	W	W	W	W	W	W	W	W	W	W	W	W	W	W	W	P	W	P	W	W	W	W	W	W	W	W	W	W	W	W	W	W	P														
W	W	W	B	W	R	R	R	W	W	W	W	W	R	R	W	W	W	W	W	W	W	W	W	W	W	W	W	W	W	W	W	W	W	W	P	W	W	W	W	W	W	W	W	W	W	W	W	P	W														
W	W	W	W	W	W	R	R	W	B	W	W	R	R	R	W	W	W	W	W	W	W	W	W	W	W	W	W	W	W	W	W	W	P	W	P	W	W	W	W	W	W	W	W	W	W	W	W	W	P														
W	W	W	W	W	W	R	R	R	B	R	R	R	R	W	W	W	W	W	U	U	U	U	U	W	U	W	W	W	W	W	W	W	W	P	W	P	W	W	W	W	W	W	W	W	W	W	W	W	P														
W	W	W	W	W	W	W	W	R	B	R	R	R	R	R	W	W	W	W	W	W	W	W	W	W	U	W	W	W	W	W	W	W	W	W	P	W	W	W	W	W	W	W	W	W	W	W	W	W	W														
W	W	W	W	W	W	W	W	W	B	W	W	W	R	R	W	W	W	W	U	W	W	W	W	W	U	W	W	W	W	W	W	W	W	W	W	P	W	P	W	W	W	W	W	W	W	W	W	W	W														
P	P	P	W	W	W	W	W	W	W	W	W	W	W	R	R	W	W	W	U	W	W	W	W	W	U	W	W	W	W	W	W	W	W	W	W	W	P	P	P	W	W	W	W	W	W	W	W	W	W														
P	P	P	W	W	W	W	W	W	W	W	W	W	W	R	R	W	W	W	U	W	W	U	U	U	U	W	W	W	W	W	W	W	W	W	W	W	W	P	T	T	W	W	W	W	W	W	W	W	W														
W	W	W	P	W	W	W	W	W	W	W	W	W	W	R	R	W	W	W	W	P	W	W	W	W	W	W	W	W	W	W	W	W	W	W	W	W	W	W	T	T	W	W	W	W	W	W	W	W	W														
W	W	W	P	P	P	W	W	W	W	W	W	W	W	R	R	W	W	W	W	P	W	W	W	W	W	W	W	W	W	W	W	W	W	W	W	W	W	W	W	W	W	W	W	W	W	W	W	W	W														
W	W	W	P	W	W	P	W	W	W	W	W	W	W	W	R	R	W	W	W	P	W	P	W	W	W	W	W	W	W	W	W	W	W	W	W	W	W	W	W	W	W	W	W	W	W	W	W	W	W														
W	W	W	W	P	W	W	W	W	W	W	W	W	W	B	B	B	B	B	W	W	P	W	P	W	W	W	W	W	W	W	W	W	W	W	W	W	W	W	W	W	W	W	W	W	W	W	W	W	W														
W	W	W	W	P	P	P	P	P	W	W	P	W	W	W	W	R	R	W	W	P	W	W	P	W	W	W	W	W	W	W	W	W	W	W	W	W	W	W	W	W	W	W	W	W	W	W	W	W	W														
W	W	W	W	W	W	W	P	W	W	P	W	W	W	W	W	W	R	R	W	W	W	W	W	W	W	W	W	W	W	W	W	W	W	W	W	W	W	W	W	W	W	W	W	W	W	W	W	W	W														
W	W	W	W	W	W	W	P	P	W	P	W	P	W	W	W	W	R	R	W	W	W	W	W	W	W	W	W	W	W	W	W	W	W	W	W	W	W	W	W	W	W	W	W	W	W	W	W	W	W														
C	W	W	W	W	W	W	W	W	W	P	W	P	W	W	W	W	R	R	W	W	W	W	W	W	W	W	W	W	W	W	W	W	W	W	W	W	W	W	W	W	W	W	W	W	W	W	W	W	C														
